1S11111111
1000011111
1011000001
1000011101
1111011111
1111011111
1000000011
1011011011
1010000011
1F11111111